{
  "LevelId": 2,
  "Width": 80,
  "Height": 23,
  "TileSize": 32,
  "Layout": [
    "................................................................................",
    "................................................................................",
    "................................................................................",
    "................................................................................",
    "................................................................................",
    "................................................................................",
    "................................................................................",
    "................................................................................",
    "................................................................................",
    "................................................................................",
    "................................................................................",
    "................................................................................",
    "................................................................................",
    "................................................................................",
    "................................................................................",
    "................................................................................",
    "......................................E............CCC..........................",
    "...................M................#####.........#####.........................",
    ".................#####..........................................................",
    "............................###..........................C......................",
    "...........................#####...........E............###...............Z.....",
    "GGGGGGGGGGGGGGGGGGGGGGGGGGGGGGGGGGGGGGGGGGGGGGGGGGGGGGGGGGGGGGGGGGGGGGGGGGGGGGGG",
    "GGGGGGGGGGGGGGGGGGGGGGGGGGGGGGGGGGGGGGGGGGGGGGGGGGGGGGGGGGGGGGGGGGGGGGGGGGGGGGGG"
  ]
}