{
  "LevelId": 2,
  "Width": 60,
  "Height": 23,
  "TileSize": 32,
  "HasBulletBill": false,
  "IsAutoScroll": false,
  "CanShoot": false,
  "Layout": [
    "............................................................",
    "............................................................",
    "............................................................",
    "............................................................",
    "............................................................",
    "............................................................",
    "............................................................",
    "............................................................",
    "............................................................",
    "............................................................",
    "............................................................",
    "............................................................",
    "............................................................",
    "............................................................",
    "............................................................",
    "............................................................",
    ".........CCC...................CCC..........................",
    ".........###.........?.........###..........................",
    "............................................................",
    "............................................................",
    ".........................................................Z..",
    "GGGGGGGGGGGGGGGGGGGGGGGGGGGGGGGGGGGGGGGGGGGGGGGGGGGGGGGGGGGG",
    "GGGGGGGGGGGGGGGGGGGGGGGGGGGGGGGGGGGGGGGGGGGGGGGGGGGGGGGGGGGG"
  ]
}