{
  "LevelId": 6,
  "Width": 60,
  "Height": 23,
  "TileSize": 32,
  "HasBulletBill": false,
  "IsAutoScroll": false,
  "CanShoot": false,
  "Layout": [
    "............................................................",
    "............................................................",
    "............................................................",
    "............................................................",
    "............................................................",
    "............................................................",
    "............................................................",
    "............................................................",
    "............................................................",
    "............................................................",
    "............................................................",
    "............................................................",
    "............................................................",
    "............................................................",
    "............................................................",
    "............................................................",
    "............................................................",
    "................P.........P..................P..............",
    "............................................................",
    "................T.....K...T.......T......K...T...........Z..",
    "GGGGGGGGGGGGGGGGGGGGGGGGGGGGGGGGGGGGGGGGGGGGGGGGGGGGGGGGGGGG",
    "GGGGGGGGGGGGGGGGGGGGGGGGGGGGGGGGGGGGGGGGGGGGGGGGGGGGGGGGGGGG"
  ]
}