{
  "LevelId": 3,
  "Width": 60,
  "Height": 23,
  "TileSize": 32,
  "HasBulletBill": false,
  "IsAutoScroll": false,
  "CanShoot": false,
  "Layout": [
    "............................................................",
    "............................................................",
    "............................................................",
    "............................................................",
    "............................................................",
    "............................................................",
    "............................................................",
    "............................................................",
    "............................................................",
    "............................................................",
    "............................................................",
    "............................................................",
    "............................................................",
    "............................................................",
    "............................................................",
    "............................................................",
    "...................................E........................",
    "................................#######...?.................",
    "............................................................",
    "............................................................",
    ".....................E...##..E...........................Z..",
    "GGGGGGGGGGGGGGGGGGGGGGGGGGGGGGGGGGGGGGGGGGGGGGGGGGGGGGGGGGGG",
    "GGGGGGGGGGGGGGGGGGGGGGGGGGGGGGGGGGGGGGGGGGGGGGGGGGGGGGGGGGGG"
  ]
}