{
  "LevelId": 3,
  "Width": 100,
  "Height": 23,
  "TileSize": 32,
  "Layout": [
    "....................................................................................................",
    "....................................................................................................",
    "....................................................................................................",
    "....................................................................................................",
    "....................................................................................................",
    "....................................................................................................",
    "....................................................................................................",
    "....................................................................................................",
    "....................................................................................................",
    "....................................................................................................",
    "....................................................................................................",
    "....................................................................................................",
    "....................................................................................................",
    "....................................................................................................",
    "....................................................................................................",
    "....................................................................................................",
    "...................................CCC..............................................................",
    "..................................#####.............................................................",
    "...................E.....................................E..........................................",
    ".......................................................#####........................................",
    ".......................###...................E..............................................Z.......",
    "GGGGGGGGGGGGGGGGGGGGGGGGGGGGGGGGGGGGGGGGGGGGGGGGGGGGGGGGGGGGGGGGGGGGGGGGGGGGGGGGGGGGGGGGGGGGGGGGGGGG",
    "GGGGGGGGGGGGGGGGGGGGGGGGGGGGGGGGGGGGGGGGGGGGGGGGGGGGGGGGGGGGGGGGGGGGGGGGGGGGGGGGGGGGGGGGGGGGGGGGGGGG"
  ]
}