{
  "LevelId": 7,
  "Width": 60,
  "Height": 23,
  "TileSize": 32,
  "HasBulletBill": false,
  "IsAutoScroll": false,
  "CanShoot": true,
  "Layout": [
    "............................................................",
    "............................................................",
    "............................................................",
    "............................................................",
    "............................................................",
    "............................................................",
    "............................................................",
    "............................................................",
    "............................................................",
    "............................................................",
    "............................................................",
    "............................................................",
    "............................................................",
    "............................................................",
    "............................................................",
    "............................................................",
    "............................................................",
    "..........?.................................................",
    "............................................................",
    "............................................................",
    "............T.....K.........E......E.....K...............Z..",
    "GGGGGGGGGGGGGGGGGGGGGGGGGGGGGGGGGGGGGGGGGGGGGGGGGGGGGGGGGGGG",
    "GGGGGGGGGGGGGGGGGGGGGGGGGGGGGGGGGGGGGGGGGGGGGGGGGGGGGGGGGGGG"
  ]
}